1111111
1E000E1
10C0001
1C000P1
1111111
