1111111111
1C1001P001
1100C00011
10C00000E1
1111111111
