111111111
100000PE1
100000001
100C0000C
111111111
