111111111111
1001C10000C1
1P00000000C1
100000E00001
111111111111
