111111111111111
1EC000000000001
101000000010101
101000000010101
1P0000000000C01
111111111111111
