11111111
1P000C11
11000001
1E00CCC1
11111111
